000100000000000
000100000000000
000100000000000
000000001000000
000000001100001
000000000000000
001000000000000
111000110000000
000000100000111
000000100000100
000000100000000
000000000000000
001000000000000
000000000000000
000000000000000
000000000000000
000100001110000
000100000001000
000100000001000
000100000001000
