000000000000000
000000000000000
000000000000000
000000000000000
000000000000000
000000000001000
111111000001111
000000000000000
000000000000000
000000000000000
000000111111000
000000000000000
000000000000000
000000000000000
111110000000000
000000000000000
000000000000000
000000000000000
000000000000000
000000011100000