000000011000000
000000010000000
000000010000000
000100000000000
000100000000001
000000000000000
000000000000000
000000000010000
111100000011000
100000000011000
100000000000000
000000000000000
000000000000000
000000000000111
000011100000001
000000100000000
000000000000000
000000000010000
000000000010000
000000000010000