000000000000000
000000000000000
000000000000000
000000000000000
000000000000000
000000000000000
000000000000000
000000000000000
000000000000000
000000000000000
000000000000000
000000000000000
000111111000111
000000000000000
000000000000000
000000000000000
000000001110000
000100000010000
000100000010000
000100000010000
