000000000000000
000000000000000
000000000000000
000000000000000
000000000000000
000000000000000
000000000000000
000000000000000
000000000000000
000000000000000
000000000000000
000000000000000
000111111000000
000000000000000
000000000000000
000000000000000
000000000111000
000100000001000
000100000001000
000100000001000
